8
-,-,-,B,-,-,-,-,-,-,-,-,-
-,B,-,-,-,-,-,-,-,D,-,-,-
-,B,-,B,-,-,-,-,-,-,-,-,-
-,-,-,B,H,-,-,T,-,-,-,-,-
-,-,V,-,-,-,-,-,-,-,-,-,-
-,-,-,-,-,-,H,-,-,-,-,T,-
-,-,-,-,-,-,-,B,-,-,-,-,-
-,V,-,T,-,-,-,B,-,-,-,-,V
-,-,-,-,-,-,-,-,-,-,-,-,-
-,-,-,-,-,B,-,-,-,-,-,-,-
-,-,-,-,-,B,B,T,-,-,-,-,-
