8
P,P,P,P,P,P,P,P,P,P,P,P,P,P,P
P,A,-,-,B,-,-,-,-,-,-,-,-,-,P
P,-,B,-,-,-,-,-,-,-,D,-,-,-,P
P,-,B,-,B,-,-,-,-,-,-,-,-,-,P
P,-,-,-,B,H,-,-,P,-,-,-,-,-,P
P,-,-,V,-,-,-,-,-,-,-,-,-,-,P
P,-,-,-,-,-,-,H,-,-,-,-,P,-,P
P,-,-,-,-,-,-,-,B,-,-,-,-,-,P
P,-,V,-,P,-,-,-,B,-,-,-,-,V,P
P,-,-,-,-,-,-,-,-,-,-,-,-,-,P
P,-,-,-,-,-,B,-,-,-,-,-,-,-,P
P,-,-,-,-,-,B,B,P,-,-,-,-,-,P
P,P,P,P,P,P,P,P,P,P,P,P,P,P,P
